111111111111111111111111
1?2222222233223322222391
1223332222b0332222222331
1b0322233200333322222b01
100332323200232233333001
100222223300323323322001
100223322111132222333001
1322332323b0322223223221
133333333200232323232321
132992222300322222299231
122b033333002333333b0221
1220022222??233222200321
132003232222222232300231
123002323332222323200321
122112233333333322211221
133b033233333223333b0331
123002322222233323200321
122003333323322233300221
132002222233222222300231
111110033300003320011111
122320022200002320003221
122220023300002220002221
100000000000000000000001
1000000000p0000000000001
1000000000k0000000000001
100000000000000000000001
100000000000000000000001
100000000000000000000001
100000000000000000000001
100000000000000000000001
100000000000000000000001
100000000000000000000001
100000000000000000000001
100000000000000000000001
100000000000000000000001
100000000000000000000001
100000000000000000000001
100000000000000000000001
100000000000000000000001
100000000000000000000001
100000000000000000000001
100000000000000000000001
100000000000000000000001
100000000000000000000001
100000000000000000000001
100000000000000000000001
100000000000000000000001
100000000000000000000001


