111111111111111111111111
122222331100113322222991
133333221100112222222331
123322231132113232222001
133332321132112233333001
132222221132112222222331
100222221123112222333331
100222231123112223333331
122333331122112323232331
100000001100110000000001
100000001100110000000001
100000001100110000000001
100000001100110000000001
100000001100110000000001
100000001100110000000001
100000001100110000000001
100000001100110000000001
100000001100110000000001
100000001100110000000001
100000001100110000000001
100000001100110000000001
100000001100110000000001
100000000000000000000001
100000000000000000000001
1000000000k0000000000001
100000000000000000000001
100000000000000000000001
100000000000000000000001
100000000000000000000001
100000000000000000000001
100000000000000000000001
100000000000000000000001
100000000000000000000001
100000000000000000000001
100000000000000000000001
100000000000000000000001
100000000000000000000001
100000000000000000000001
100000000000000000000001
100000000000000000000001
100000000000000000000001
100000000000000000000001
100000000000000000000001
100000000000000000000001
100000000000000000000001
100000000000000000000001
100000000000000000000001
100000000000000000000001
