111111111111111111111111
1??882288288228822882991
1227733773b0337733773381
1b0664466400446644664b01
100555555500555555555001
100446644600664466446001
100337733711173377337001
1332288228b0882288228271
144882288200228822882361
155993377300337733799251
166b044664004466446b0241
1770055555??555555500331
188006644677664466400221
122007733766773377300381
133118822855882288211271
144b022882442288228b0361
155003377333337733700351
166004466422446644600241
177005555588555555500231
111110044600004460011121
122770033700003370003281
133660022800002280004271
100000000000000000000001
1000000000p0000000000001
1000000000k0000000000001
100000000000000000000001
100000000000000000000001
100000000000000000000001
100000000000000000000001
100000000000000000000001
100000000000000000000001
100000000000000000000001
100000000000000000000001
100000000000000000000001
100000000000000000000001
100000000000000000000001
100000000000000000000001
100000000000000000000001
100000000000000000000001
100000000000000000000001
100000000000000000000001
100000000000000000000001
100000000000000000000001
100000000000000000000001
100000000000000000000001
100000000000000000000001
100000000000000000000001
100000000000000000000001


