111111111111111111111111
199222??11b011??22222991
133333221100112222222331
123322231100113232222231
133332321100112233333231
132222221199112222222221
1232222211??112222333331
132222232223222223333221
133333333322332323232321
132992222233222222299231
122??33333223333333??221
122b022222332222222b0322
132003232222233232300231
123002323333322323200321
122002232222232322200221
133333323333322333333331
123232322222233323232321
122333333333322233333221
132222222200222222333231
133322223300333322333331
122332322200222323233221
12222222330p332222222221
100000000000000000000001
100000000000000000000001
1000000000k0000000000001
100000000000000000000001
100000000000000000000001
100000000000000000000001
100000000000000000000001
100000000000000000000001
100000000000000000000001
100000000000000000000001
100000000000000000000001
100000000000000000000001
100000000000000000000001
100000000000000000000001
100000000000000000000001
100000000000000000000001
100000000000000000000001
100000000000000000000001
100000000000000000000001
100000000000000000000001
100000000000000000000001
100000000000000000000001
100000000000000000000001
100000000000000000000001
100000000000000000000001
100000000000000000000001
