111111111111111111111111
199222??11b011??22222991
133333221100112222222331
123322231100113232222231
133332323300332233333231
132222222299222222222221
1232222233??332222333331
132222232223222223333221
133333333322332323232321
132992222233222222299231
122??33333223333333??221
122b022222332222222b0322
132003231122113232300231
123002321133112323200321
122002231122112322200221
133333321133112333333331
123232321122113323232321
122333331133112233333221
132222221100112222333231
133322221100113322333331
122332321100112323233221
12222222110p112222222221
100000000000000000000001
100000000000000000000001
1000000000k0000000000001
100000000000000000000001
100000000000000000000001
100000000000000000000001
100000000000000000000001
100000000000000000000001
100000000000000000000001
100000000000000000000001
100000000000000000000001
100000000000000000000001
100000000000000000000001
100000000000000000000001
100000000000000000000001
100000000000000000000001
100000000000000000000001
100000000000000000000001
100000000000000000000001
100000000000000000000001
100000000000000000000001
100000000000000000000001
100000000000000000000001
100000000000000000000001
100000000000000000000001
100000000000000000000001
