111111111111111111111111
199222??11b011??22222991
133333221100112222222331
123322231100113232222231
133332321100112233333231
132222221132112222222221
1b0222221123112222333b01
100222231123112223333001
100333331122112323232001
100222221133112222222001
122333331122113333333221
1??222221133112222222??1
132323231122113232323231
1232323211??112323232321
122222b0112211b022222221
133333001133110033333331
123232001122110023232321
122333001133110033333221
132222221100112222333231
133322991100119922333331
1??332321100112323233??1
12222222110p112222222221
100000000000000000000001
100000000000000000000001
1000000000k0000000000001
100000000000000000000001
100000000000000000000001
100000000000000000000001
100000000000000000000001
100000000000000000000001
100000000000000000000001
100000000000000000000001
100000000000000000000001
100000000000000000000001
100000000000000000000001
100000000000000000000001
100000000000000000000001
100000000000000000000001
100000000000000000000001
100000000000000000000001
100000000000000000000001
100000000000000000000001
100000000000000000000001
100000000000000000000001
100000000000000000000001
100000000000000000000001
100000000000000000000001
100000000000000000000001
