111111111111111111111111
199222??11b011??22222991
133333221100112222222331
123322231100113232222231
133332321100112233333231
132222221132112222222221
1b0222221123112222333b01
100222231123112223333001
100333331122112323232001
100222221133112222222001
122333331100113333333221
1??222221100112222222??1
132323231100113232323231
123232321100112323232321
122222b0110011b022222221
100000001100110000000001
100000001100110000000001
100000001100110000000001
100000001100110000000001
100000991100119900000001
10000000110p110000000001
100000001100110000000001
100000000000000000000001
100000000000000000000001
1000000000k0000000000001
100000000000000000000001
100000000000000000000001
100000000000000000000001
100000000000000000000001
100000000000000000000001
100000000000000000000001
100000000000000000000001
100000000000000000000001
100000000000000000000001
100000000000000000000001
100000000000000000000001
100000000000000000000001
100000000000000000000001
100000000000000000000001
100000000000000000000001
100000000000000000000001
100000000000000000000001
100000000000000000000001
100000000000000000000001
100000000000000000000001
100000000000000000000001
100000000000000000000001
100000000000000000000001
