111111111111111111111111
155225522559955225522551
144334433442244334433441
1b0443344333333443344b01
100552255224422552255001
10022552255??55225522001
100334111111111111433001
133443333445544333344331
122552244332233442255221
155995555223322555599551
144b044225544552244b0441
1330033334??244333300331
122002244311233442200221
155005555211322555500551
144114422511355224411441
133223333411344333322331
122332244311233442233221
155445555211322555544551
144554422500255224455331
133200033400344330002221
122300044300233440003551
155400055200322550004441
100000000000000000000001
1000000000p0000000000001
100000000000000000000001
100000000000000000000001
1000000000k0000000000001
100000000000000000000001
100000000000000000000001
100000000000000000000001
100000000000000000000001
100000000000000000000001
100000000000000000000001
100000000000000000000001
100000000000000000000001
100000000000000000000001
100000000000000000000001
100000000000000000000001
100000000000000000000001
100000000000000000000001
100000000000000000000001
100000000000000000000001
100000000000000000000001
100000000000000000000001
100000000000000000000001
100000000000000000000001
100000000000000000000001
100000000000000000000001

