111111111111111111111111
122222222239923322222111
122333222233232222222331
1b0322233222333232222b01
100332323222232233333001
10022222323??23322222001
100222222111112222333001
132222232223222223333221
133333333322332323232321
132992222233222222299231
122b033333223333333b0221
122002222233222222200321
132003232222233232300231
123002323333322323200321
122112233333333322211221
133333323333322333333331
123232322222233323232321
1223333333??322233333221
132222222211222222333231
133300023311333320003331
122300022211222320003221
122200023311332220002221
100000000000000000000001
1000000000p0000000000001
1000000000k0000000000001
100000000000000000000001
100000000000000000000001
100000000000000000000001
100000000000000000000001
100000000000000000000001
100000000000000000000001
100000000000000000000001
100000000000000000000001
100000000000000000000001
100000000000000000000001
100000000000000000000001
100000000000000000000001
100000000000000000000001
100000000000000000000001
100000000000000000000001
100000000000000000000001
100000000000000000000001
100000000000000000000001
100000000000000000000001
100000000000000000000001
100000000000000000000001
100000000000000000000001
100000000000000000000001

